A format is NEVER part of a data recovery or disk rebuild process and if done in such circumstances will normally lead to loss of all data on the disks being formatted=En formatering är **ALDRIG** en del av en dataåterställning eller diskåteruppbyggnadsprocess, och om det görs under sådana omständigheter kommer det normalt att leda till förlust av all data på de diskar som formateras.
Aborted=Avbruten
Action=Åtgärd
Add Pool=Lägg till pool
Add Subpool=Lägg till subpool
Add ZFS Subpool=Lägg till ZFS-subpool
Add=Lägg till
All existing data on this device will be OVERWRITTEN when array is Started=All existerande data på den här enheten kommer att SKRIVAS ÖVER när arrayet startas!
Array Devices=Arrayenheter
Array of %s devices=Array med %s enheter
Array Operation=Arrayoperation
Attribute Name=Attributnamn
Attributes not available=Attributen är inte tillgängliga
Attributes=Attribut
auto=auto
Autotrim=Autotrim
Balance Status=Balansstatus
Balance=Balans
Blacklisted=Svartlistad
Boot Device=Bootenhet
Boot system in UEFI mode=Starta systemet i UEFI-läge
btrfs balance status=btrfs balansstatus
btrfs check status=btrfs kontrollstatus
btrfs filesystem df=btrfs filsystem df
BTRFS operation is running=BTRFS-operationen körs
btrfs scrub status=btrfs skrubbstatus
cache - Cache Devices=cache - Cacheenheter
Canceled=Avbruten
Cannot contact key-server. Please check your=Kan inte kontakta nyckelserver. Vänligen kontrollera din
Capabilities not available=Kapabiliteterna är inte tillgängliga
Capabilities=Kapabiliteter
Check Filesystem Status=Kontrollera filsystemstatus
Clear Stats=Rensa statistik
Clearing in progress=Rensning pågår
Click on FLASH above this message=Klicka på **FLASH** ovanför det här meddelandet
Click to spin down device=Klicka för att stänga av enhet
Click to spin up device=Klicka för att sätta på enhet
Comments=Kommentarer
complete=komplett
Completed without error=Slutfört utan fel
completed=slutfört
Compression=Komprimering
Configuration valid=Konfiguration giltig
Convert to raid0 mode=Konvertera till raid0-läge
Convert to raid1 mode=Konvertera till raid1-läge
Convert to raid10 mode=Konvertera till raid10-läge
Convert to raid1c3 mode=Konvertera till raid1c3-läge
Convert to raid1c4 mode=Konvertera till raid1c4-läge
Convert to raid5 mode see help=Konvertera till raid5-läge *se hjälp
Convert to raid6 mode see help=Konvertera till raid6-läge *se hjälp
Convert to single mode=Konvertera till enkelt läge
Copying=Kopierar
corrected=korrigerad
Create an empty file system on the disks shown as Unmountable discarding all data currently on the disks and update parity to reflect this=Skapa ett tomt filsystem på de diskar som visas som **Omonterbara**, kassera all data som för närvarande finns på diskarna och uppdatera paritet för att återspegla detta
creating Flash backup zip file this may take several minutes=Skapar Flash-backup zip-fil (detta kan ta flera minuter)
Creating Flash backup=Skapar Flash-backup
Creation error=Skapelsefel
Critical disk temperature threshold=Kritisk disktemperatursgräns
Critical disk utilization threshold=Kritisk diskanvändningsgräns
Critical NVME temperature threshold=Kritisk NVME-temperaturgräns
Critical SSD temperature threshold=Kritisk SSD-temperaturgräns
Current operation %s on %s=Aktuell operation %s på **%s**
Current position=Nuvarande position
Custom attributes use comma to separate numbers=Egna attribut, använd komma för att separera siffror
Data-Rebuild in progress=Dataåteruppbyggnad pågår
Date of purchase=Inköpsdatum
Date=Datum
dedup - Deduplication Tables=dedup - Dedupliceringstabeller
Delete Pool=Ta bort pool
detected=detekterad
Device contents invalid, in standby mode spun-down=Enhetsinnehåll ogiltigt, i viloläge (nedstängd)
Device contents invalid=Enhetsinnehåll ogiltigt
Device encrypted and unlocked=Enhet krypterad och upplåst
Device encrypted=Enhet krypterad
Device is disabled=Enhet är inaktiverad
Device is missing (disabled)=Enhet saknas (inaktiverad)
Device is part of a pool=Enhet är en del av en pool
Device locked, unknown error=Enhet låst, okänt fel
Device locked, wrong encryption key=Enhet låst, fel krypteringsnyckel
Device to be encrypted=Enhet som ska krypteras
Disable Spin down delay to run a SMART extended self-test=Inaktivera **Spin down delay** för att köra ett SMART utökat självtest
Disk in parity slot is not biggest=Disk i paritetsslot är inte störst
Disk Log Information=Disklogginformation
Disk-Clear in progress=Diskrensning pågår
Do not use reserved names=Använd inte reserverade namn
Do not use user share names=Använd inte användardelade namn
Download SMART report=Ladda ner SMART-rapport
Dual parity valid requires ALL disks in their original slots=*Dual parity* 'giltig' kräver att **ALLA** diskar är i sina ursprungliga platser
Elapsed time=Förfluten tid
Enable user share assignment=Aktivera användardelningstilldelning
encrypted=krypterad
Encryption input=Krypteringsinput
Encryption status=Krypteringsstatus
Enter new key=Skriv in ny nyckel
Erase Device Content=Radera enhetsinnehåll
Errors occurred - Check SMART report=Fel inträffade - Kontrollera SMART-rapport
Estimated finish=Beräknad sluttid
Estimated speed=Beräknad hastighet
Existing content is permanently lost=Existerande innehåll är permanent förlorat
Failed=Misslyckades
Feature=Funktion
File system status=Filsystemstatus
File system type=Filsystemtyp
Finding %s error=Hittar **%s** fel
Finding %s errors=Hittar **%s** fel
Flag=Flagga
Flash backup=Flash-backup
Flash device is set as public share=Flash-enhet är inställd som offentlig delning
Flash Device Settings=Inställningar för Flash-enhet
Format Unmountable disks=Formatera omonterbara diskar
Formatting=Formaterar
formatting=formaterar
Free=Ledig
FS=FS
Global Configuration=Global konfiguration
Hide=Göm
Identification=Identifikation
Identity is not available=Identitet är inte tillgänglig
Identity=Identitet
if checked, Start array but do not mount disks=om ibockad, Starta array men montera inte diskar
If this is a new array, move the largest disk into the parity slot=Om detta är en ny array, flytta den största disken till paritetsslot
If you are adding a new disk or replacing a disabled disk, try Parity-Swap=Om du lägger till en ny disk eller byter ut en inaktiverad disk, försök med Parity-Swap
Incorrect confirmation=Felaktig bekräftelse
Information=Information
Insufficient free disk space available=Otillräckligt diskutrymme tillgängligt
Interrupted=Avbruten
Invalid configuration=Ogiltig konfiguration
invalid device=ogiltig enhet
invalid devices=ogiltiga enheter
Invalid expansion=Ogiltig utökning
Invalid pool name=Ogiltigt poolnamn
Invalid, missing or expired=Ogiltig, saknas eller har gått ut
is only available when array is Started in Maintenance mode=bara tillgängligt när arrayet är Startat i **Underhållsläge**
is only available when array is Started=bara tillgängligt när arrayet är Startat
Keyfile=Nyckelfil
Last check completed on %s=Senaste kontroll färdigställd den **%s**
Last check incomplete on %s=Senaste kontroll ej färdigställd den **%s**
Last checked on %s=Senaste kontroll den **%s**
Last SMART test result=Senaste SMART-testresultat
logs - ZFS Intent Log=loggar - ZFS Intent Log
Maintenance mode=Underhållsläge
Maintenance Mode=Underhållsläge
Maintenance=Underhåll
Manufacturing date=Tillverkningsdatum
Menu View=Menyn Vy
Minimum free space=Minimalt ledigt utrymme
mirror=mirror
Missing Cache disk=Saknad cache-disk
Missing disk=Saknad disk
Missing key=Saknad nyckel
Missing pool disk=Saknad pool-disk
Missing=Saknas
Mounted=Monterad
Mover is running=Flyttaren körs
network settings=nätverksinställningar
New data disks detected=Nya datadiskar detekterade
next device=nästa enhet
No array data disks have been assigned=Inga array-datadiskar har tilldelats
No data disks=Inga datadiskar
no devices=inga enheter
No parity check history present=Ingen paritetskontrollhistorik tillgänglig
No self-tests logged on this disk=Inga självtester loggade på denna disk
Not installed=Inte installerad
Not present=Inte närvarande
OK=OK
Once copy completes, the array may be Started, to initiate Data-Rebuild of the disabled disk=När kopieringen är klar kan arrayet startas för att initiera Data-Rebuild av den inaktiverade disken
operation=operation
Options see Help=Alternativ (se Hjälp)
Otherwise use the keyfile method for UTF8 input=Annars använd **nyckelfil**-metoden för UTF8-input
Parity disks content will be overwritten=*Paritets* disk(ar) innehåll kommer att skrivas över
Parity is already valid=Paritet är redan giltig
Parity Operation History=Paritetsoperationshistorik
Parity operation is running=Paritetsoperationen körs
Parity valid requires ALL disks to have their original content=*Paritet giltig* kräver **ALLA** diskar att ha sitt ursprungliga innehåll
Parity-Check in progress=Paritetskontroll pågår
ParityRead-Check History=Paritet/Läs-kontrollhistorik
Parity-Sync in progress=Paritet-Sync pågår
Parity-Sync/Data-Rebuild in progress=Paritet-Sync/Data-Rebuild pågår
Partition format=Partitionformat
Partition size=Partitionstorlek
Passed=Godkänd
Passphrase=Accessord
Perform full balance=Utför full balans
Permit UEFI boot mode=Tillåt UEFI-bootläge
Please change share SMB security=Vänligen ändra SMB-säkerheten för delningen
Please check your system settings to support UEFI boot mode=Vänligen kontrollera dina systeminställningar för att stödja UEFI-bootläge
Please try again=Vänligen försök igen
Pool Devices=Poolenheter
Pool name already exists=Poolnamn redan existerar
Pool of %s devices=Pool med %s enheter
Pool Status=Poolstatus
Power=Ström
Preclear in progress=Förrensa pågår
previous device=föregående enhet
Printable Characters Only=Endast utskrivbara tecken
Proceed to start=Fortsätt för att starta
raid0=raid0
raid1=raid1
raid10=raid10
raid1c3=raid1c3
raid1c4=raid1c4
raid5=raid5
raid6=raid6
raidz=raidz
raidz2=raidz2
raidz3=raidz3
Raw Value=Rawvärde
Raw View=Rawvy
Read errors corrected=Läsa fel korrigerade
Read errors detected=Läsa fel upptäckta
Read-Check in progress=Läsa-kontroll pågår
Reading=Läser
Reboot in safe mode=Starta om i felsäkert läge
Registration Key Manager=Registreringsnyckelhanterare
registration key=registreringsnyckel
ReiserFS is deprecated, please use another file system=ReiserFS är föråldrat, använd ett annat filsystem
reiserfsck status=reiserfsck status
Rename Pool=Byt namn på pool
Repair corrupted blocks=Reparera korrumperade block
Replacement disk installed=Ersättningsdisk installerad
Replacement disk is too small=Ersättningsdisk är för liten
Retype passphrase=Återställ lösenfras
Schedule=Schema
Scrub Status=Skrapstatus
Scrub=Skrapa
See %s Settings=Se %s Inställningar
self-test in progress=Självtest pågår
Self-Test=Självtest
Server boot mode=Serverstartläge
Set default boot menu=Ställ in standard bootmeny
show passphrase=Visa lösenfras
Show=Visa
single=singel
Slots=Platser
SMART attribute notifications=SMART-attributaviseringar
SMART controller type=SMART-kontrolltyp
SMART error log=SMART-fel logg
SMART extended self-test=SMART utökat självtest
SMART health-check failed=SMART hälsokontroll misslyckades
SMART notification tolerance level=SMART-aviseringstoleransnivå
SMART notification value=SMART-aviseringvärde
SMART self-test history=SMART självtesthistorik
SMART self-test in progress=SMART självtest pågår
SMART Settings=SMART-inställningar
SMART short self-test=SMART kort självtest
SMART status=SMART-status
spares - Hot Spares=reservdelar - Hot Spares
special - Special Allocation Class=speciell - Special Allokeringsklass
Speed=Hastighet
Spin down delay=Spin down-fördröjning
Spin Down=Spin Down
Spin Up=Spin Up
Spinup groups=Spinup-grupper
Started, array protected=Startad, array skyddad
Started, array unprotected=Startad, array oskyddad
Started, clearing=Startad, rensning
Started, formatting=Startad, formatering
Starting, copying=Startar, kopierar
Starting=Startar
Stopping=Stoppar
Sync errors corrected=Synkroniseringsfel korrigerade
Sync errors detected=Synkroniseringsfel upptäckta
Sync errors=Synkroniseringsfel
Sync=Synkronisering
Syslinux Configuration=Syslinux-konfiguration
Syslinux configuration=Syslinux-konfiguration
Temp=Temp
The array will be immediately available, but unprotected since parity has not been assigned=Arrayet kommer omedelbart att vara tillgängligt, men **oskyddat** eftersom *paritet* inte har tilldelats
The array will be immediately available, but unprotected until Parity-Sync completes=Arrayet kommer omedelbart att vara tillgängligt, men **oskyddat** tills Parity-Sync är slutfört
The replacement disk must be as big or bigger than the original=Ersättningsdisken måste vara lika stor eller större än den ursprungliga
This is typically done when a new disk is added to the array to get it ready for files to be written to it=Detta görs vanligtvis när en ny disk läggs till arrayet för att förbereda den för att ta emot filer
This Unraid OS release has been withdrawn and may no longer be used. Please=Denna Unraid OS-version har dragits tillbaka och får inte längre användas. Vänligen
This will ERASE ALL device content=Detta kommer att RADERA ALLT enhetsinnehåll
This will ERASE content of ALL devices in the pool=Detta kommer att RADERA innehållet på ALLA enheter i poolen
This will reboot the system=Detta kommer att starta om systemet
This will shutdown the system=Detta kommer att stänga av systemet
This will stop the array=Detta kommer att stoppa arrayet
This will stop the running operation=Detta kommer att stoppa den pågående operationen
Threshold=Tröskel
Title=Rubrik
To confirm your action type: %s=För att bekräfta din åtgärd skriv: %s
Toggle reads/writes display=Växla visning av läs/skriv
Too many attached devices. Please consider upgrading your=För många anslutna enheter. Vänligen överväg att uppgradera din
Too many wrong and/or missing disks=För många felaktiga och/eller saknade diskar
Total size=Total storlek
Unassign ALL devices to delete this pool=Avdela **ALLA** enheter för att ta bort denna pool
Unassigned Devices=Avdelade enheter
Unavailable - disk must be spun up=Otillgänglig - disk måste startas
unavailable (no parity-check entries logged)=otillgänglig (inga paritetskontrollinmatningar loggade)
Unavailable=Otillgänglig
Unclean shutdown detected=Oren stängning detekterad
Unmountable disk present=Omonterbar disk närvarande
Unmountable disks present=Omonterbara diskar närvarande
Unmountable: Encrypted volume present=Omonterbar: Krypterad volym närvarande
Unmountable: Missing encryption key=Omonterbar: Saknad krypteringsnyckel
Unmountable: No file system=Omonterbar: Inget filsystem
Unmountable: No pool uuid=Omonterbar: Ingen pool-uuid
Unmountable: not btrfs pool=Omonterbar: inte btrfs pool
Unmountable: Unsupported or no file system=Omonterbar: Stöds inte eller inget filsystem
Unmountable: Volume not encrypted=Omonterbar: Volymen är inte krypterad
Unmounted=Avmonterad
Upgrading disk/swapping parity=Uppgraderar disk/byter paritet
Use ASCII characters from space ' ' to tilde '~'=Använd **ASCII**-tecken från mellanslag ' ' till tilde '~'
Use Default=Använd standard
Use default=Använd standard
Use only lowercase with no special characters or leading/trailing digits=Använd endast små bokstäver utan specialtecken eller ledande/avslutande siffror
use printable characters only=använd endast utskrivbara tecken
Used=Använd
Value=Värde
W=W
WARNING canceling may leave the array unprotected=VARNING: att avbryta kan lämna arrayet oskyddat
Warning disk temperature threshold=Varning disktemperaturtröskel
Warning disk utilization threshold=Varning diskutnyttjande tröskel
Warning NVME temperature threshold=Varning NVME-temperaturtröskel
Warning SSD temperature threshold=Varning SSD-temperaturtröskel
WARNING=VARNING
Warranty period=Garanti period
will activate a clean system power down=kommer att aktivera en *ren* systemavstängning
will activate a clean system reset=kommer att aktivera en *ren* systemåterställning
will bring the array on-line and start Clearing new data disk(s)=kommer att ta arrayet online och starta **Rensning** av nya datadisk(ar)
will bring the array on-line and start Data-Rebuild=kommer att ta arrayet online och starta **Data-Rebuild**
will bring the array on-line and start Disk-Clear of new data disk(s)=kommer att ta arrayet online och starta **Disk-Clear** av nya datadisk(ar)
will bring the array on-line and start Parity-Check=kommer att ta arrayet online och starta **Paritetskontroll**
will bring the array on-line and start Parity-Sync and/or Data-Rebuild=kommer att ta arrayet online och starta **Paritet-Sync** och/eller **Data-Rebuild**
will bring the array on-line and start Parity-Sync=kommer att ta arrayet online och starta **Paritet-Sync**
will bring the array on-line=kommer att ta arrayet online
will copy the parity information to the new parity disk=kommer att kopiera paritetsinformationen till den nya *paritet* disken
will create a file system in all Unmountable disks=kommer att skapa ett filsystem på alla **omonterbara** diskar
will delete the encryption keyfile=kommer att ta bort krypteringsnyckelfilen
will disable the missing disk and then bring the array on-line. Install a replacement disk as soon as possible=kommer att inaktivera den saknade disken och sedan ta arrayet online. Installera en ersättningsdisk så snart som möjligt
will expand the file system of the data disk; if possible then bring the array on-line and start Data-Rebuild=kommer att expandera filsystemet på datadisk, om möjligt, för att sedan ta arrayet online och starta Data-Rebuild
will immediately clear all disk statistics=kommer omedelbart att rensa all diskstatistik
will immediately invoke the Mover=kommer omedelbart att kalla på Flyttaren
will immediately spin down all disks=kommer omedelbart att spinna ner alla diskar
will immediately spin up all disks=kommer omedelbart att spinna upp alla diskar
will pause Data-Rebuild=kommer att pausa Data-Rebuild
will pause Disk-Clear=kommer att pausa Disk-Clear
will pause Parity-Check=kommer att pausa Paritetskontroll
will pause Parity-Sync=kommer att pausa Paritet-Sync
will pause Read-Check=kommer att pausa Läs-kontroll
will pause the Clearing=kommer att pausa Rensning
will pause the Parity-Check=kommer att pausa Paritetskontroll
will pause the Parity-Sync/Data-Rebuild=kommer att pausa Paritet-Sync/Data-Rebuild
will pause the Read-Check=kommer att pausa Läs-kontroll
will record all disk information, bring the array on-line, and start Parity-Sync=kommer att registrera all diskinformation, ta arrayet online och starta Paritet-Sync
will remove the missing cache disk and then bring the array on-line=kommer att ta bort den saknade cachdisken och sedan ta arrayet online
will remove the missing pool disk and then bring the array on-line=kommer att ta bort den saknade pooldisken och sedan ta arrayet online
will resume Data-Rebuild=kommer att återuppta Data-Rebuild
will resume Disk-Clear=kommer att återuppta Disk-Clear
will resume Parity-Check=kommer att återuppta Paritetskontroll
will resume Parity-Sync=kommer att återuppta Paritet-Sync
will resume Read-Check=kommer att återuppta Läs-kontroll
will resume the paused Clearing=kommer att återuppta den pausade Rensningen
will resume the paused Parity-Check=kommer att återuppta den pausade Paritetskontrollen
will resume the paused Parity-Sync/Data-Rebuild=kommer att återuppta den pausade Paritet-Sync/Data-Rebuild
will resume the paused Read-Check=kommer att återuppta den pausade Läs-kontrollen
will start Clearing new data disk(s)=kommer att starta **Rensning** av nya datadisk(ar)
will start Data-Rebuild=kommer att starta **Data-Rebuild**
will start Disk-Clear of new data disk(s)=kommer att starta **Disk-Clear** av nya datadisk(ar)
will start Parity-Check=kommer att starta **Paritetskontroll**
will start Parity-Sync and/or Data-Rebuild=kommer att starta **Paritet-Sync** och/eller **Data-Rebuild**
will start Parity-Sync=kommer att starta **Paritet-Sync**
will start Read-Check of all array disks=kommer att starta **Läs-kontroll** av alla array-diskar
will stop Clearing=kommer att stoppa Rensning
will stop Data-Rebuild=kommer att stoppa Data-Rebuild
will stop Disk-Clear=kommer att stoppa Disk-Clear
will stop Parity-Check=kommer att stoppa Paritetskontroll
will stop Parity-Sync=kommer att stoppa Paritet-Sync
will stop Parity-Sync/Data-Rebuild=kommer att stoppa Paritet-Sync/Data-Rebuild
will stop Read-Check=kommer att stoppa Läs-kontroll
will stop the Parity-Check=kommer att stoppa Paritetskontroll
will stop the Read-Check=kommer att stoppa Läs-kontroll
will take the array off-line=kommer att ta arrayet offline
Worst=Värst
Write corrections to parity=Skriva korrigeringar till paritet
Writes=Skriver
Wrong key=Fel nyckel
Wrong Pool State=Fel poolstatus
xfs_repair status=xfs_repair-status
You may not add new disks and also remove existing disks=Du kan inte lägga till nya diskar och samtidigt ta bort befintliga diskar
your server=din server
zfs pool status=zfs pool-status
zfs=zfs



; Sleep plugin translations
Check this=Kontrollera detta
for more information=för mer information
Make sure your server supports S3 sleep=Se till att din server stödjer S3-sleep
Sleep will immediately put the server in sleep mode=**Sleep** kommer omedelbart att sätta servern i viloläge
Sleeping=Sover
System in sleep mode=Systemet är i viloläge
This will put the system in sleep mode=Detta kommer att sätta systemet i viloläge
wiki entry=wiki-post

; Note: December 17, 2023 - 299 missing translations

; Note from willing Translator: (July 20, 2024) I don't know if the asterisks will cause problems or not ex. **word** 
; I have no Idea what kind of effect it would have to the text in the UI or terminal. So someone should look it over and possibly delete those.
