20 EHCI=2.0 (EHCI)
30 nec XHCI=3.0 (nec XHCI)
30 qemu XHCI=3.0 (qemu XHCI)
Allocation=Tilldelning
and if using graphics device passthrough it too needs UEFI=
Are you sure=Är du säker
Array must be started to view Virtual Machines=Array måste vara **startad** för att visa Virtuella Maskiner
Autostart=Starta automatiskt
Back=Tillbaka
Bus=
Capacity=Kapacitet
Change Icon=Ändra Ikon
Cleanup=Städa bort
Click and Select cdrom image to install operating system=Klicka och välj diskavbildning för att installera operativsystem
Config Folder=Konfigurations-katalog
Copy Paste Domain XML Configuration Here=Kopiera &amp; klistra in domän XML konfiguration här
CPU Mode=CPU-läge
CPUs=CPUer
Create=Skapa
Creating=Skapar
define the amount memory=definera mängden minne
define the maximum amount of memory=definera den maximala mängden minne
define type of cpu presented to this vm=definera typ av CPU som ska användas till denna vm
description of virtual machine=beskrivning av virtuella maskinen
Disk devices=Diskenheter
Download Folder=Ladda ner katalog
Download, Click and Select virtio drivers image=
Downloading=Laddar ner
eg=e.g.
Emulated=Emulerad
Extracting=Extraherar
Folder to save the LibreELEC image to=Katalog att spara LibreELEC diskavbildning till
Folder to save the OpenELEC image to=Katalog att spara OpenELEC diskavbildning till
Form View=Tabellvy
free=ledigt
Graphics Card=Grafikkort
Graphics ROM BIOS=Grafik ROM BIOS
Graphics=Grafik
Host Passthrough=
Hyperv tweaks for Windows=
Hyper-V=Hyper-V
i440fx will work for most=i440fx fungerar oftast
Icon=Ikon
Initial=
Invalid VM to edit=Ogiltig VM att redigera
ISO storage path doesnt exist=ISO lagringsplatsen existerar inte
ISO storage path was empty=ISO lagringsplatsen var tom
keyboard for VNC=Tangentbord för VNC
LibreELEC Version=LibreELEC-version
LibreELEC=LibreELEC
Libvirt Service failed to start=Libvirt-tjänsten misslyckades att starta
Logical CPUs=Logiska CPUer
Machine=Maskin
Manual=
Max=Max
MD5 verification failed, your download is incomplete or corrupted=MD5-verifiering misslyckades, din nedladdning är inkomplett eller skadad
mount tag inside vm=
My Workstation=Min Arbetsstation
name of mount tag inside vm=
Name of virtual machine=Namn på virtuell maskin
Network Bridge=Nätverksbrygga
Network MAC=Nätverks-MAC
Network Model=Nätverksmodell
No Virtual Machines installed=Inga Virtuella Maskiner installerade
None available=Ingen tillgänglig
Not enough free space, need at least=Inte tillräckligt med ledigt utrymme, behöver åtminstone
Not running=Körs ej
OpenELEC Version=OpenELEC-version
OpenELEC=OpenELEC
OS Install CDRom Bus=
OS Install ISO=OS Installations-ISO
Other PCI Devices=Andra PCI-enheter
OVMF requires a UEFI-compatable OS=OVMF kräver ett UEFI-kompatibelt operativsystem
OVMF=OVMF
password for VNC=lösenord för VNC
path of Unraid share=
path on Unraid share to save LibreELEC settings=
path on Unraid share to save OpenELEC settings=
Path to ROM BIOS file=
Please choose a folder the LibreELEC image will download to=
Please choose a folder the OpenELEC image will download to=
Primary=Primär
Q35 for a newer machine model with PCIE=
QEMU64=QEMU64
random mac, you can supply your own=slumpvald mac, du kan ange en egen
re-generate random mac address=återskapa slumpmässig mac-address
Remove LibreELEC image=
Remove OpenELEC image=
Remove this LibreELEC file=
Remove this OpenELEC file=
SeaBIOS will work for most=
SeaBIOS=SeaBIOS
Select the BIOS=Välj BIOS
Select the LibreELEC version to use=Välj LibreELEC-version
Select the machine model=Välj maskinmodell
Select the OpenELEC version to use=Välj OpenELEC-version
Select the USB Controller to emulate=Välj USB-kontroller att emulera
Separate sub-folder and image will be created based on Name=
shares=
Some OSes wont support USB3=Vissa operativsystem stöder inte USB3
Sound Card=Ljudkort
Start All=Starta Alla
Start VM after creation=Starta VM efter skapandet
Stop All=Stoppa Alla
Toggle VM autostart=Växla VM-autostart
type of storage image=
Unknown action=Okänd åtgärd
Unknown version=Okänd version
Unraid Mount tag=
Unraid Share=
Updating=Uppdaterar
USB Controller=USB-kontroller
USB Devices=USB-enheter
vDisk Bus=
vDisk Location=
vDisk Size=
vDisk Type=
vDisks=
video for VNC=
VirtIO Drivers CDRom Bus=
VirtIO Drivers ISO=
Virtual Machines=Virtuella Maskiner
VM creation error=
VM image deletion error=
VNC Keyboard=VNC Tangentbord
VNC Password=VNC Lösenord
VNC Video Driver=VNC-videodrivrutin
VNC=VNC
Wasnt able to stop the process=Kunde ej stoppa processen
Windows 7XP=Windows 7/XP
Windows 82012, newer Linux distros=Windows 8/2012, nyare Linux distributioner
XML View=XML Vy
